1111111111111111111111111111111111
1E1000000001N10C00000C000000000001
1010010100101000101001000000010101
1010010010101010001001000000010101
1P0000000C00C00000000000000N000NC1
1111111111111111111111111111111111